.--------------------.
|H                   |
.--------.           |
|        |           |
|        |     ------.
|    i               |
|      .-----.-------.
|      |     |       |
|      |            i|
|      |     |       |
|            |       |
.---.        .---.---.
|            | p |   |
| o |    |   .   .   |
.---.    |           |
| X      |      i    |
.--------.-----------.