.-.----------------.-.
|X|        H       |X|
|i|        i       |i|
| |                | |
| |                | |
| |                | |
| |                | |
| |                | |
|          p         |
| |                | |
| |                | |
| |                | |
| |                | |
| |                | |
|i|                |X|
|X|        X       |o|
.-.----------------.-.