.-----------------.--.
|      i         H|p |
|   .-------------.  |
|   |             |  |
|   |             |  |
|   |             |  |
|   |             |  |
|                i|  |
|X  ------------. |  |
|             i | |  |
|             i | |  |
| ---.----------. |  |
|    |            |  |
| i  |     X      |  |
.----.   ---------.  |
|o X                 |
.--------------------.