.-----.--------------.
|X    |     p       X|
|     |              |
|     |              |
|     .---------     |
|     |              |
|     i              |
| --------.-.---- ---.
|         |H|        |
|         .i.        |
|         |          |
|         |          |
|         |          |
|         |       i  |
|         |          |
|        o| X        |
.---------.----------.