.-.----------------.-.
|X|        H       |X|
|i|        i       |i|
| |                | |
| |                | |
| |                | |
| |                | |
| |                | |
|          p         |
| |                | |
| |                | |
| |                | |
| |                | |
| |                | |
|i|                |o|
|X|        X       |X|
.-.----------------.-.