.----------.---------.
|X         |        X|
|          |    i    |
|                    |
|   p        --------.
|       |            |
|       |            |
|       |            |
| ------.-----.----  |
|             |      |
|             |      |
|i            |      |
.-----------  .  ----.
| X           |     H|
|             |      |
| o           |    i |
.-------------.------.